ALLEGRE	Matthieu		1
ANDRIAMAKAOLY	Jeremy		1
ARBISA	Maxime		1
BAKIR	Myriam		1
BERTHIER	Paul		1
BOUDET	Matthieu		1
BROOKS	Daniel		1
CHEBAANE	Radhwane		1
DAUBRESSE	Nicolas		1
DUDRAGNE	Geoffrey		1
EHRENSTREM	Axel		1
FERRIE	Baptiste		1
FONTAINE	Charly		1
GUILLET-GROBOILLOT	Adele		1
JIANG	Paul		1
JOUMAR	Soufiane		1
KANMOGNE-CHATCHUENG	Joffrey		1
LALLEMENT	GuEnolE		1
MACHRAA	Aimane		1
QUENEE	Emile		1
QUINTIN	Virgile		1
RAIMUNDO	FElix		1
SAYAG	JErEmy		1
SIRBU	Maxime		1
TOUSSA	Delali		1
VALIOLLAH-POUR-AMIRI	Valeh		1
WULFMAN	Pierre-Emmanuel		1
YCART	Adrien		1
ALLOUCH	Imen		2
ARONIO-DE-ROMBLAY	Axel		2
BLANCHET	Aymeric		2
BORNE-PONS	Hugo		2
BOUTAUT	Pierre		2
BOUYOUX	Guillaume		2
BRISTOL-COURGEON	NoEmie		2
CAMARA	Issa		2
CONGARD	ClEment		2
DE-SAINTE-AGATHE	Pierre		2
DUBOIS	Angelina		2
GARREAU	Corentin		2
GIRAUD	Benedicte		2
GIVAJA	Gabriel		2
GOTCHAC	Nicolas		2
HURABIELLE-CLAVERIE	Adele		2
JARRY	Viktor		2
JMAIEL	Wajih		2
LACROIX	Corentin		2
LUTFALLA	Adrien		2
MARCELLIN	Jean-Baptiste		2
MICHEL	Louise		2
NEJMI	Anas		2
PIATTE	Guillaume		2
RANDRIANALIJAFY	Tahina		2
RICHET	Gabriel		2
ROZES	Emilie		2
SEIGNOL	Edouard		2
TANAKA	Alban		2
VALLET	Hugo		2
ASSARAF	Karene		3
AYADI	Wadie		3
BEOGO	Wend-La-Sida		3
BESBES	Ahmed		3
BONANNO	Stephane		3
BRETON	SEbastien		3
CHENG	Yu-Ling		3
CHEVALIER	Mathieu		3
DECOUZON	REmi		3
FOURNERET	Audrey		3
GOESTER	Nicolas		3
GROSCOT	Raphael		3
KAHN	Antoine		3
KERIBIN	Muriel		3
LALAMI	Soufiane		3
LE-GUEN	Yann		3
LOUDET	Julien		3
MARTIN	Simon		3
MESSAGER	Antoine		3
MOUJAHID	Sara		3
NANAKASSE	Fatoumata		3
OUAKI	Arthur		3
POTIEZ--GALI	Hadrien		3
RAINER	Gilles		3
RIBAULT	Alnour		3
TIMOFTI	Vincent		3
TORRENTS	Alexandrine		3
TRINQUIER	Nicolas		3
YANG	Dominique		3
BELLAHSEN	Otmane		4
BOISDUR	Lea		4
BUFFET	Matthieu		4
CHABOT	Vincent		4
CHENNA	Sarah		4
DEBERDT	Guillaume		4
DUVAL	SEbastien		4
FRANCIS	Danny		4
GHARBI	Wiem		4
GODEL	Wenceslas		4
GUEDOU	Thibaut		4
HADDAD	JErEmy		4
HAMAIDE	GrEgoire		4
LELONG	Agathe		4
LELOUP	LEonard		4
LE-QUESNE	TimothEe		4
LOLLO	Daniel		4
MATISSART	Adrien		4
MOURY	Charles		4
ORMEZZANO	Thomas		4
OULHAJ	Mohamed		4
PENG	LEa		4
RANAIVOSON	Cynthia		4
ROEDER	Damien		4
ROTELLA	Yann		4
SOULE	Guillaume		4
WADIL	Hakim		4
ZARROUK	Skander		4
ZHANG	Xudong		4
ACHARD	Bastien		5
AYMONOD	Maxime		5
BERREBBI	Nathan		5
BOST	Lisa		5
CHOLLET	Paul		5
COHEN	StEphanie		5
CROZE	Romain		5
DIAZ	ThEophane		5
DUVERGIER	Simon		5
FOURATI	Sami		5
GERARD	Henri		5
GOSSELIN	Alice		5
HUSSON	Antoine		5
ISNARDY	Antoine		5
LABIADH	Marouene		5
LEMAISTRE	Laetitia		5
LORIEUL	Titouan		5
LOUIBA	Sofiane		5
MAMI	Mohamed-Hassen		5
MEYER	Arthur		5
PAILLOT	Guillaume		5
PETKANTCHIN	Ivaylo		5
PRIEUR-DREVON	GaEtan		5
RHAZI-FILALI	Nora		5
ROUSSEAU	Thomas		5
SUCHET	Guillaume		5
TANG	Mengmeng		5
TASSINARI	Olivier		5
YEMBELE	Alexandra		5
